111111111111111111111111
1P001C0100000000010010E1
10001001C000011101000001
1000100111111100010010C1
100000000000C10000001111
111011110000010011100001
100000010000010010000001
10000C010000000010000C01
111111111111111111111111
